NO ./textures/north.xpm
SO ./textures/south.xpm
WE ./textures/west.xpm
EA ./textures/east.xpm

F 100,100,100
C 200,200,255

111111111111
100000000001
1000N0000001
100000000001
111111111111
